1111111111111011111111111111111111111
110000001000000C001001000000000011101
1010010000100000100001000000010101111
10CC010010101010001001000000010111111
110001001C00C00C0C1100010100000001111
11111111111111111111111PCE11111101101
1111111111111011111111111111111111111
